abbotsford' value='abbotsford'>Abbotsford
abilene' value='abilene'>Abilene, TX
akron-canton' value='akron-canton'>Akron / Canton
albany-capital-region' value='albany-capital-region'>Albany / Capital Region
albuquerque' value='albuquerque'>Albuquerque
allentown-reading' value='allentown-reading'>Allentown / Reading
amarillo' value='amarillo'>Amarillo
anchorage' value='anchorage'>Anchorage
ann-arbor' value='ann-arbor'>Ann Arbor
asheville' value='asheville'>Asheville
athens-ga' value='athens-ga'>Athens, GA
atlanta' value='atlanta'>Atlanta
augusta' value='augusta'>Augusta
austin' value='austin'>Austin
bakersfield' value='bakersfield'>Bakersfield
baltimore' value='baltimore'>Baltimore
barrie' value='barrie'>Barrie
baton-rouge' value='baton-rouge'>Baton Rouge
beaumont' value='beaumont'>Beaumont, TX
billings' value='billings'>Billings / Bozeman
birmingham' value='birmingham'>Birmingham
bloomington-in' value='bloomington-in'>Bloomington, IN
boise' value='boise'>Boise
boston' value='boston'>Boston
buffalo' value='buffalo'>Buffalo
calgary' value='calgary'>Calgary
cape-breton' value='cape-breton'>Cape Breton
cedar-rapids-iowa-city' value='cedar-rapids-iowa-city'>Cedar Rapids / Iowa City
central-jersey' value='central-jersey'>Central Jersey
charleston' value='charleston'>Charleston
charleston-wv' value='charleston-wv'>Charleston, WV
charlotte' value='charlotte'>Charlotte
chattanooga' value='chattanooga'>Chattanooga
chicago' selected='selected' value='chicago'>Chicago
cincinnati' value='cincinnati'>Cincinnati
cleveland' value='cleveland'>Cleveland
colorado-springs' value='colorado-springs'>Colorado Springs
columbia' value='columbia'>Columbia
columbia-mo' value='columbia-mo'>Columbia, MO
columbus' value='columbus'>Columbus
columbus-ga' value='columbus-ga'>Columbus GA
corpus-christi' value='corpus-christi'>Corpus Christi
dallas' value='dallas'>Dallas
dayton' value='dayton'>Dayton
daytona-beach' value='daytona-beach'>Daytona Beach
denver' value='denver'>Denver
des-moines' value='des-moines'>Des Moines
detroit' value='detroit'>Detroit
edmonton' value='edmonton'>Edmonton
el-paso' value='el-paso'>El Paso
erie' value='erie'>Erie
eugene' value='eugene'>Eugene
evansville' value='evansville'>Evansville
fairfield-county' value='fairfield-county'>Fairfield County
fort-lauderdale' value='fort-lauderdale'>Fort Lauderdale
fort-myers-cape-coral' value='fort-myers-cape-coral'>Fort Myers / Cape Coral
fort-wayne' value='fort-wayne'>Fort Wayne
fort-worth' value='fort-worth'>Fort Worth
appleton' value='appleton'>Fox Cities
fresno' value='fresno'>Fresno
gainesville' value='gainesville'>Gainesville
grand-rapids' value='grand-rapids'>Grand Rapids
green-bay' value='green-bay'>Green Bay
greenville' value='greenville'>Greenville
halifax' value='halifax'>Halifax
hampton-roads' value='hampton-roads'>Hampton Roads
harrisburg' value='harrisburg'>Harrisburg / Lancaster
hartford' value='hartford'>Hartford
honolulu' value='honolulu'>Honolulu
houston' value='houston'>Houston
huntsville' value='huntsville'>Huntsville
indianapolis' value='indianapolis'>Indianapolis
inland-empire' value='inland-empire'>Inland Empire
jackson' value='jackson'>Jackson
jacksonville' value='jacksonville'>Jacksonville
kalamazoo' value='kalamazoo'>Kalamazoo
kansas-city' value='kansas-city'>Kansas City
kelowna' value='kelowna'>Kelowna
kingston' value='kingston'>Kingston / Belleville
kitchener-waterloo' value='kitchener-waterloo'>Kitchener - Waterloo
knoxville' value='knoxville'>Knoxville
lakeland' value='lakeland'>Lakeland
lansing' value='lansing'>Lansing
las-vegas' value='las-vegas'>Las Vegas
lexington' value='lexington'>Lexington
lincoln' value='lincoln'>Lincoln
little-rock' value='little-rock'>Little Rock
london' value='london'>London, ON
long-island' value='long-island'>Long Island
                              <optgroup label='Los Angeles'>
                                <option data-bhc='Area:los-angeles' value='los-angeles:los-angeles'>Los Angeles
                                <option data-bhc='Area:san-gabriel-valley' value='los-angeles:san-gabriel-valley'>San Gabriel Valley
                                <option data-bhc='Area:san-fernando-valley' value='los-angeles:san-fernando-valley'>San Fernando Valley
                              </optgroup>
louisville' value='louisville'>Louisville
lubbock' value='lubbock'>Lubbock
macon' value='macon'>Macon
madison' value='madison'>Madison
memphis' value='memphis'>Memphis
miami' value='miami'>Miami
midland-odessa' value='midland-odessa'>Midland / Odessa
milwaukee' value='milwaukee'>Milwaukee
minneapolis-stpaul' value='minneapolis-stpaul'>Minneapolis / St Paul
mobile-baldwin-county' value='mobile-baldwin-county'>Mobile / Baldwin County
modesto' value='modesto'>Modesto
montgomery' value='montgomery'>Montgomery
napa-sonoma' value='napa-sonoma'>Napa / Sonoma
naples' value='naples'>Naples
nashville' value='nashville'>Nashville
new-orleans' value='new-orleans'>New Orleans
new-york' value='new-york'>New York City
north-jersey' value='north-jersey'>North Jersey
ocala' value='ocala'>Ocala
ogden' value='ogden'>Ogden
oklahoma-city' value='oklahoma-city'>Oklahoma City
omaha' value='omaha'>Omaha
orange-county' value='orange-county'>Orange County
orlando' value='orlando'>Orlando
ottawa' value='ottawa'>Ottawa
palm-beach' value='palm-beach'>Palm Beach
pensacola' value='pensacola'>Pensacola / Emerald Coast
philadelphia' value='philadelphia'>Philadelphia
phoenix' value='phoenix'>Phoenix
piedmont-triad' value='piedmont-triad'>Piedmont Triad
pittsburgh' value='pittsburgh'>Pittsburgh
portland' value='portland'>Portland
portland-me' value='portland-me'>Portland, ME
providence' value='providence'>Providence
raleigh-durham' value='raleigh-durham'>Raleigh / Durham
regina' value='regina'>Regina
reno' value='reno'>Reno
richmond' value='richmond'>Richmond
rio-grande-valley' value='rio-grande-valley'>Rio Grande Valley
roanoke' value='roanoke'>Roanoke
rochester' value='rochester'>Rochester
rockford' value='rockford'>Rockford
sacramento' value='sacramento'>Sacramento
salem-or' value='salem-or'>Salem OR
salt-lake-city' value='salt-lake-city'>Salt Lake City
san-angelo' value='san-angelo'>San Angelo
san-antonio' value='san-antonio'>San Antonio
san-diego' value='san-diego'>San Diego
                              <optgroup label='San Francisco'>
                                <option data-bhc='Area:san-francisco' value='san-francisco:san-francisco'>San Francisco
                                <option data-bhc='Area:east-bay' value='san-francisco:east-bay'>East Bay
                              </optgroup>
san-jose' value='san-jose'>San Jose
santa-barbara' value='santa-barbara'>Santa Barbara
santa-clarita' value='santa-clarita'>Santa Clarita
santa-cruz' value='santa-cruz'>Santa Cruz / Monterey
saskatoon' value='saskatoon'>Saskatoon
savannah-hilton-head' value='savannah-hilton-head'>Savannah / Hilton Head
                              <optgroup label='Seattle'>
                                <option data-bhc='Area:tacoma' value='seattle:tacoma'>Tacoma
                                <option data-bhc='Area:seattle' value='seattle:seattle'>Seattle
                              </optgroup>
shreveport-bossier' value='shreveport-bossier'>Shreveport / Bossier
sioux-falls' value='sioux-falls'>Sioux Falls
south-bend' value='south-bend'>South Bend
albany-ga' value='albany-ga'>Southern Georgia
spokane-coeur-dalene' value='spokane-coeur-dalene'>Spokane / Coeur d'Alene
springfield-mo' value='springfield-mo'>Springfield MO
springfield-ma' value='springfield-ma'>Springfield, MA
stcatharines-niagara' value='stcatharines-niagara'>St Catharines-Niagara
st-johns' value='st-johns'>St John's
stlouis' value='stlouis'>St Louis
stockton' value='stockton'>Stockton
sudbury' value='sudbury'>Sudbury / North Bay
syracuse' value='syracuse'>Syracuse
tallahassee' value='tallahassee'>Tallahassee
tampa-bay-area' value='tampa-bay-area'>Tampa Bay Area
toledo' value='toledo'>Toledo
topeka-lawrence' value='topeka-lawrence'>Topeka / Lawrence
greater-toronto-area' value='greater-toronto-area'>Toronto (GTA)
tucson' value='tucson'>Tucson
tulsa' value='tulsa'>Tulsa
vancouver' value='vancouver'>Vancouver
ventura-county' value='ventura-county'>Ventura County
victoria' value='victoria'>Victoria
                              <optgroup label='Washington DC'>
                                <option data-bhc='Area:dc-metro' value='washington-dc:dc-metro'>The District
                                <option data-bhc='Area:northern-virginia' value='washington-dc:northern-virginia'>Northern Virginia
                                <option data-bhc='Area:montgomery-county' value='washington-dc:montgomery-county'>Montgomery County
                              </optgroup>
westchester-county' value='westchester-county'>Westchester County
wichita' value='wichita'>Wichita
wilmington-newark' value='wilmington-newark'>Wilmington-Newark
windsor' value='windsor'>Windsor
winnipeg' value='winnipeg'>Winnipeg
worcester' value='worcester'>Worcester
youngstown' value='youngstown'>Youngstown
